WE srcs/textures/wall1.XPM
SO srcs/textures/wall2.XPM
NO srcs/textures/wall3.XPM
EA srcs/textures/wall4.XPM
F 25,184,11
C 117,225,253
1111111111111111111111111
1000000000110000010000001
1000000000110000010000001
1000000000110000010000001
1000000000110000010000001
1000N00000110000010000001
1000000000110000010000001
1000000000110000010000001
1000000000110000010000001
1000000000110000010000001
1111111111111111111111111
